



BBBBBBBBBBBBBBBBBBBBBBBBBBBBBBBBBBBBBBBBBBBBBBBBBBBBBBBBBBBBBBBBBBBBBBBBBBBBBBBBBB
BTTTTTTTTTTTTTTTTTTTTTTTTTTTTTTTTTTTTTTTTTTTTTTTTTTTTTTTTTTTTTTTTTTTTTTTTTTTTTTTTB
BTTTTTTTTTTTTTTTTTTTTTTTT1111322TTTTTTTTTTTTTTTTTTTTTTTTTTTTTTTTTTTTTTTTTTTTTTTTTB
BTTTTTTTTTTTTTTTTTTTT11111112222222TTTTTTTTTTTTTTTTTTT1112222111TTTTTTTTTTTTTTTTTB
BTTTTTTTTTTTTTTTTTT11111132222222222TTTTTTTTTTTTTTTT111222222222221TTTTTTTTTTTTTTB
BTTTTTTTTTTTTTT111111132222222222222222TTTTTTTTTTT111222222222222222211TTTTTTTTTTB
BTTTTTTTTTTT111111132222222222222222222222TTTTTT1111222222222222222222221TTTTTTTTB
BTTTTTTT1111111132222222222222222222222222222T11113222222222222222222222221TTTTTTB
BTTT1111111322222222222222222222222222222231111122222222222222222222222222221TTTTB
BT11113322222222222222222222222222222222222222222222222222222222222222222222222TTB
B22222222222222222222222222222222222222222222222222222222222222222222222222222222B
B22222222222222222222222222222222222222222222222222222222222222222222222222222222B
B22222222222222222222222222222222222222222222222222222222222222222222222222222222B
B22222222222222222222222222222222222222222222222222222222222222222222222222222222B
B22222222222222222222222222222222222222222222222222222222222222222222222222222222B
B22222222222222222222222222222222222222222222222222222222222222222222222222222222B
B22222222222222222222222222222222222222222222222222222222222222222222222222222222B
B22222222222222222222222222222222222222222222222222222222222222222222222222222222B
B22222222222222222222222222222222222222222222222222222222222222222222222222222222B
B22222222222222222222222222222222222222222222222222222222222222222222222222222222B
B22222222222222222222222222222222222222222XX22X2222222222222222222222222222222222B
B222222222222222222222222222222222222222XXX22XX2222222222222222222222222222222222B
B22222222222222222222222222222222XXXXXXXXX2XXX22222222222222222222222222222222222B
BBBBBBBBBBBBBBBBBBBBBBBBBBBBBBBBBBBBBBBBBBBBBBBBBBBBBBBBBBBBBBBBBBBBBBBBBBBBBBBBBB